##########
#b  X t X#
#%       #
#   C   g#
#  * ?  g#
#g     # #
#  C   #C#
#m    O# #
#T X   #E#
##########
