OOOOOOOOOO
OOOOOOOOOO
##########
#m%  X X #
# %    # #
#E%  C C #
######   #
OOOOO#####
OOOOOOOOOO
OOOOOOOOOO
